11111
10C01
10101
1C1E1
1P0C1
11111