111111
1EC1P1
100111
1C00C1
111111