11111111111111111111
1P010000111100000C11
10C00110E11001100011
1111011000000C111C11
1C0001C01110100C1011
11111111111111111111